仙=僊
沉=沈
岳=嶽
恆=恒
毗=毘
祐=佑
秘=祕
唯=惟
楊=揚
溪=谿
裡=裏
寧=甯
廢=癈
慧=惠
牆=墻
耀=曜
辯=辨
尒=爾
歛=斂
體=体
蟲=虫
玅=妙
脩=修
纔=才
繞=遶
佗=他
秏=耗
實=寔
污=汙
校=挍
個=箇
虱=蝨
蠍=蝎
脣=唇
溼=濕
妓=伎
荅=答
臺=台
喫=吃
駁=駮
淫=婬
旛=幡
鉛=鈆
趨=趍
欲=慾
鎌=鐮
搯=掐
